10 6
5 2
1 1 1 1 1 1 1 1 1 1
1 0 0 1 1 1 1 1 1 1
1 0 3 2 3 0 4 0 0 1
1 1 0 0 1 2 0 0 0 1
1 1 1 0 0 0 1 1 1 1
1 1 1 1 1 1 1 1 1 1