10 9
7 6
1 1 1 1 1 1 1 1 1 1
1 0 0 1 1 1 0 0 1 1
1 0 0 1 0 2 2 0 1 1
1 0 2 2 0 1 0 0 1 1
1 0 0 0 0 1 0 0 1 1
1 1 1 0 2 3 1 0 0 1
1 1 1 3 3 4 3 0 3 1
1 1 1 1 0 0 0 1 1 1
1 1 1 1 1 1 1 1 1 1