13 9
6 4
1 1 1 1 1 1 1 1 1 1 1 1 1
1 1 1 0 0 0 1 0 0 0 1 1 1
1 1 0 2 1 0 1 0 1 2 1 1 1
1 0 0 0 1 3 0 3 1 0 0 0 1
1 0 2 0 4 3 0 3 4 0 2 0 1
1 0 0 0 1 3 0 3 1 0 0 0 1
1 1 1 2 1 0 1 0 1 2 0 1 1
1 1 1 0 0 0 1 0 0 0 1 1 1
1 1 1 1 1 1 1 1 1 1 1 1 1
