11 9
7 4
1 1 1 1 1 1 1 1 1 1 1
1 1 0 0 0 0 1 0 0 1 1
1 1 0 2 0 2 0 0 0 1 1
1 1 1 0 1 1 1 0 0 1 1
1 1 1 0 1 4 1 0 1 1 1
1 0 0 0 1 1 1 0 0 0 1
1 0 1 0 3 0 3 0 0 0 1
1 0 0 0 1 1 1 1 1 1 1
1 1 1 1 1 1 1 1 1 1 1