6 6
2 4
1 1 1 1 1 1 1
1 1 3 1 1 1 1
1 0 2 0 3 1 1
1 0 2 1 1 1 1
1 0 0 1 1 1 1
1 1 1 1 1 1 1
